A	Porque	Poder	passada_passada_passada
ALERTA	SUS	Simples	mandando_mandando_mandando
Acho	RJ	Dr.	chama_chama_chama
Ajude	YouTube	BR	A Globo	divulgar_divulgar_divulgar
Alckmin	COMPARTILHEM	Copa	Pastor	veio_veio_veio
Arthur	Manuela	BRASIL	Repassem	Twitter	Veja_Veja_Veja
BBC	Acabei	Esquerda	Trump	sair_sair_sair
Bresser	PQD	Vasco	tomar_tomar_tomar
CONTRATA	Limpeza	Clique	enviar_enviar_enviar
Ciro Gomes	Supremo	Quero	acabar_acabar_acabar
Compartilhem	Fernando Haddad	FDP	Espero	Pai	Presidente	seja_seja_seja
DILMA	Gleisi	SPC	Trabalho	chegar_chegar_chegar
Diego	Apocalipse	presidente Lula	preso_preso_preso
Dilma Rousseff	Envie	H1N1	fica_fica_fica
Eduardo Bolsonaro	Basta	Vale	conferir_conferir_conferir
El	Nasa	Copa	Ontem	publicou_publicou_publicou
FAVOR	VENEZUELANOS	Suzano	VENENO	TEM_TEM_TEM
FIFA	Fifa	US$	OAS	PSL	aplaudiu_aplaudiu_aplaudiu
FIFA	US$	Messenger	Nike	aceitarem_aceitarem_aceitarem
Federal	Amazonas	Nova	Amarildo	Culto	Maria	disse_disse_disse
Federal	Bresser	Google	recebemos_recebemos_recebemos
Fernando Haddad	Google	Acredite	quiser_quiser_quiser
Gleisi	Direitos Humanos	Mensagem	Partido Novo	pede_pede_pede
Gleisi	Mariana	Ontem	Villas	chegou_chegou_chegou
Globo News	Red Bull	Marielle	USP	Maio	Leia	fala_fala_fala
Pais	Compartilhem	Governo	Nordeste	vencer_vencer_vencer
Israel	Francisco	Rodrigo Maia	mandou_mandou_mandou
LULA	Estados Unidos	Gandhi	recebeu_recebeu_recebeu
Leia	Estados Unidos	Texto	escrito_escrito_escrito
Lula Livre	Europa	Acabo	Voce	Meu	MENSAGEM	Clique	PIS	Acabei	receber_receber_receber
MG	Obrigado	Tava	fiquei_fiquei_fiquei
Marcelo	Messi	Neymar	Cristiano Ronaldo	recusou_recusou_recusou
Guilherme	CUT	Marcelo Rezende	Avenida Paulista	pediu_pediu_pediu
Mc Donalds	McDonalds	Cuidado	Terra	dando_dando_dando
Meu	Sou	TODOS	Existe_Existe_Existe
Minas	Jorge	Ricardo	tinha_tinha_tinha
Net	Pastor	Espanha	chamando_chamando_chamando
P	R$70,00	Acabei	ficar_ficar_ficar
PCC	Arthur	Ricardo	salvo_salvo_salvo
PESSOA	Hospital	Acredite	trabalha_trabalha_trabalha
PIS	Voce	SIM	registrado_registrado_registrado
PR	PRF	Bahia	deu_deu_deu
Cuidado	CUT	Papa	Sabe	pedindo_pedindo_pedindo
Passe	Compartilhe	Clique	digite_digite_digite
Porque	ALERTA	Barra da Tijuca	existem_existem_existem
Porque	Tocantins	POVO	Augusto Blat	Amazonas	Vou	Veja	Pernambuco	repassando_repassando_repassando
Precisamos	Russia	USP	abrir_abrir_abrir
R$	Senna	COMPARTILHE	feita_feita_feita
Recife	MOMO	Pastor	Sabe	dizendo_dizendo_dizendo
Red Bull	Alerta	Limpeza	RJ	feito_feito_feito
REPASSEM	SUA	TODOS OS	ESTAMOS_ESTAMOS_ESTAMOS
Sabemos	G1	Habeas Corpus	existe_existe_existe
Sou	Lucas	BR	OBS	entrar_entrar_entrar
Supremo	INSS	UMA	concedeu_concedeu_concedeu
UAI	COMPARTILHE	TODOS	marcada_marcada_marcada
Venezuela	Trump	Presidente da	manda_manda_manda
Whatsapp	HADDAD	Diga	chamado_chamado_chamado
